Level.Design PacMan


19, 18, 18, 26, 26, 26, 26, 0, 19, 22, 0, 19, 18, 18, 22,
17, 16, 20, 0, 0, 0, 21, 0, 17, 20, 0, 17, 16, 16, 20,
17, 24, 24, 18, 26, 26, 28, 0, 17, 20, 0, 17, 24, 24, 28,
21, 0, 0, 21, 0, 0, 0, 0, 17, 20, 0, 21, 0, 0, 0,
21, 0, 19, 24, 26, 26, 22, 0, 17, 20, 0, 17, 18, 18, 22,
21, 0, 21, 0, 0, 0, 21, 0, 17, 16, 26, 24, 24, 16, 20,
21, 0, 21, 0, 0, 0, 21, 0, 17, 20, 0, 0, 0, 17, 20,
21, 0, 25, 18, 18, 26, 28, 0, 17, 16, 18, 18, 26, 24, 28,
21, 0, 0, 17, 20, 0, 0, 0, 17, 16, 16, 20, 0, 0, 0,
17, 18, 18, 24, 24, 26, 18, 26, 24, 24, 24, 24, 16, 26, 22,
17, 16, 20, 0, 0, 0, 21, 0, 0, 0, 0, 0, 21, 0, 21,
17, 16, 20, 0, 0, 19, 16, 18, 26, 18, 18, 26, 20, 0, 21,
17, 24, 24, 26, 26, 24, 16, 20, 0, 17, 20, 0, 21, 0, 21,
21, 0, 0, 0, 0, 0, 17, 20, 0, 17, 20, 0, 21, 0, 21,
25, 26, 26, 26, 26, 26, 24, 24, 26, 24, 24, 26, 24, 26, 28



